Roy	Franklin
Mario	Gardner
Willis	Romero
Max	Wilkerson
Latoya	Larson
Abel	Anderson
Enrique	Townsend
Geneva	Reed
Lynette	Gilbert
Tracy	Sanders
Audrey	Quinn
Diana	Johnston
Blanche	Dawson
Seth	Mccormick
Lola	Evans
Hubert	Day
Bertha	Malone
Ramona	Taylor
Sheldon	Sandoval
Shaun	Bradley
Hazel	Roberson
Kenneth	Martin
Hannah	Morales
Jeannie	Horton
Joey	Waters
Claire	Fleming
Brittany	Collins
Marilyn	Saunders
Glenn	Fitzgerald
Julia	Tran
Gerard	Bowen
Clifford	Stevens
Wallace	Bailey
Samuel	Schneider
Angie	George
Kerry	Scott
Kent	Walton
Tomas	Rowe
Sophie	Cook
Marion	Weber
Phil	May
Vernon	Harper
Byron	Burke
Nora	Pittman
Salvatore	Stevenson
Daryl	Farmer
Sonja	Warren
Carlton	Goodwin
Noah	Graham
Clyde	Chavez
Jacquelyn	Santos
Mitchell	Arnold
Wayne	Ellis
Chelsea	Patrick
Melody	Snyder
Everett	Barrett
Ginger	Nichols
Ernestine	Clark
Kendra	Diaz
Kelli	Simmons
Darla	Douglas
Harry	Henry
Allen	Colon
Joel	Sparks
Melissa	Manning
Angel	Obrien
Yolanda	Robbins
Herbert	Pratt
Sally	Christensen
Lee	Bates
Tanya	James
Clark	Porter
Lance	Carson
Guadalupe	Barber
Raquel	Ramirez
Edwin	Brooks
Eunice	Sims
Jan	Freeman
Lucas	Cain
Jody	Nguyen
Leo	Morton
Dwayne	Oliver
Thelma	Boyd
Jonathan	Harris
Timothy	Roberts
Wade	Welch
Lula	Jordan
Carl	Vaughn
Terrell	Bryan
Lela	Zimmerman
Rogelio	Summers
Jaime	Baker
Jackie	Sharp
Erica	Mccarthy
Marlon	Cobb
Rex	Wagner
Matthew	Hampton
Russell	Martinez
Lillian	Steele
Terrance	Lucas
Dustin	Gregory
Timothy	Reed
David	Bishop
Julius	Morton
Cory	Lawrence
Ricky	Silva
Kelly	Foster
Gary	Griffith
Josefina	Garrett
Sabrina	Norton
Rene	Cook
Matthew	Williams
Nick	Riley
Lynda	Taylor
Shelly	Garcia
Winifred	Soto
Gene	Sanchez
Shari	Owen
Pauline	Park
Peter	Rodgers
Kayla	Simmons
Jonathan	Barker
Guadalupe	Collins
Samuel	Ortiz
Jake	Snyder
Judy	Mcdaniel
Rosa	Lloyd
Courtney	Hogan
Paulette	Colon
Lonnie	Butler
Elvira	Howard
Herman	Collier
Ray	Green
Rosemary	Harrington
Marshall	Richardson
Jerry	Miles
Della	Hopkins
Sergio	Gardner
Freddie	Wheeler
Delores	Morgan
Ismael	Ryan
Ellis	Evans
Beth	Goodman
Craig	Washington
Claudia	Holland
Kristen	Gonzalez
Maurice	Jenkins
Theresa	Leonard
Roberta	Wright
Luis	Tucker
Gail	Norman
Tracy	Hawkins
Lisa	Christensen
Elias	Mann
Gertrude	Mcdonald
Judith	Brooks
Melanie	Poole
Frances	Powell
Sam	Summers
Horace	Cain
Eunice	Ford
Preston	Harper
Rolando	Bush
Mitchell	Fernandez
Jill	Carpenter
Joann	Cunningham
Franklin	Cross
Rachel	Wade
Jack	Brewer
Kellie	Tate
Jeanne	Garza
Jermaine	Olson
Amber	Gibbs
Dan	Richards
Tricia	Hubbard
Diane	Walsh
Doreen	Blake
Rickey	Schultz
Lana	Cortez
Mable	Daniel
Sherry	Jacobs
Katie	Medina
Charlotte	Knight
Dana	Gilbert
Aubrey	Rios
Floyd	Rose
Lynn	Zimmerman
Bernard	Fields
Hugo	Price
Stephen	Burns
Warren	Vasquez
Esther	Peters
Roderick	Wise
Stacy	Munoz
Sheila	Austin
Bert	Newman
Jenny	Andrews
Ian	Spencer
Alicia	Tran
Jamie	Potter
Allan	Mullins
Courtney	Wong
Dolores	Mason
Frankie	Stone
Iris	Barrett
Kenneth	Adams
Winifred	Castillo
Darlene	Keller
Lee	Henderson
Leona	Saunders
Robin	Nelson
Verna	Rowe
Dora	Johnston
Jacob	Underwood
Terrance	Rice
Ted	Phillips
Joann	Ball
Jake	Fox
Bridget	Dunn
Marguerite	Herrera
Miriam	Bell
Raymond	Norton
Marta	Baker
Jose	Blair
Danny	Payne
Felix	Leonard
Sophia	Bowers
Omar	Hopkins
Lynn	King
Lawrence	Ortiz
April	Stewart
Gail	Estrada
Zachary	Robertson
Saul	Fletcher
Stanley	Terry
Garrett	Hines
Melba	Vargas
Thomas	Wood
Lyle	Webster
Kari	Lindsey
Luz	Sandoval
Renee	Edwards
Nathaniel	Harmon
Harry	Fitzgerald
Robyn	Alvarado
Angel	Kelley
Ricardo	Willis
Minnie	Aguilar
Pedro	Nunez
Lynn	Larson
Travis	Roberson
Lydia	Luna
Henrietta	Jones
Merle	Potter
Gwendolyn	Price
Vera	Webb
Kerry	Brewer
Bruce	Newman
Cecil	Rose
Lindsey	Mcbride
Wilson	Jimenez
Ruby	Freeman
Tasha	Powers
Andrew	Chapman
Tracy	Drake
Dominic	Chavez
Patti	Harper
Ervin	Ward
Vicky	Glover
Edgar	Neal
Karl	Morgan
Thelma	Hogan
Maurice	Mccoy
Allison	Kim
Monica	Santiago
Debbie	Hughes
Joyce	Hammond
Wilma	Richardson
Leigh	Robbins
Irving	Stephens
Alan	Spencer
Shannon	Johnson
Herman	Klein
Rafael	Blake
Irma	Kennedy
Della	Torres
Opal	Garner
Nellie	Maxwell
Belinda	Hernandez
Lynne	Sparks
Catherine	Owen
Sergio	Boone
Rickey	Wagner
Tracey	Lamb
Gabriel	Gutierrez
Kathy	Howard
Laurence	Vasquez
Josephine	Brock
Kurt	Flores
Stephen	Francis
